####################
#..................#
#..................#
#...###......###...#
#...#..........#...#
#...#..........#...#
#...#..........#...#
#...#..........#...#
#...#..........#...#
#...#..........#...#
#...#..........#...#
#...#..........#...#
#...#..........#...#
#...#..........#...#
#...#..........#...#
#...#..........#...#
#...###......###...#
#..................#
#p.................#
####################