####################
#..................#
#..................#
#...###......###...#
#...#..........#...#
#...#..........#...#
#..................#
#..................#
#..................#
#..................#
#..................#
#..................#
#..................#
#..................#
#...#..........#...#
#...#..........#...#
#...###......###...#
#..p...............#
#..................#
####################