####################
#..................#
#..................#
#...############...#
#..................#
#..................#
#..................#
#..................#
#..................#
######.............#
#.............######
#..................#
#..................#
#..................#
#..................#
#..................#
#...############...#
#..p...............#
#..................#
####################